40
40
1 1 1 1 1 1 1 1 1 3 3 3 3 1 1 1 1 1 1 1 2 1 1 1 1 1 4 4 4 2 2 2 2 3 2 1 4 4 1 1 
1 1 1 1 1 1 1 3 3 3 3 3 3 1 1 1 1 1 2 2 2 4 1 1 1 4 4 4 4 2 3 2 2 2 1 2 4 4 4 1 
1 1 1 1 1 1 1 1 3 3 1 1 1 1 1 1 1 4 4 4 4 4 2 1 1 1 4 2 4 4 2 2 2 1 1 2 1 1 4 1 
1 1 1 1 1 1 1 3 3 1 1 1 1 1 1 1 4 4 4 4 4 2 1 1 1 1 4 4 2 2 2 2 1 1 1 1 4 4 2 1 
1 1 1 1 1 1 1 4 4 3 1 1 4 1 1 4 4 4 1 4 4 2 2 1 3 1 1 1 1 2 2 2 2 1 3 4 4 4 4 2 
1 1 1 1 1 1 3 4 3 4 4 4 4 4 4 4 4 4 4 4 2 1 1 3 3 3 1 1 2 2 2 1 2 1 3 4 4 4 1 1 
1 1 1 1 1 1 3 3 4 4 4 4 4 1 4 4 4 4 1 4 4 1 1 1 3 3 3 3 3 3 2 3 3 1 3 1 1 2 3 1 
1 2 1 1 2 1 1 3 3 1 4 4 4 4 2 4 4 4 4 4 1 1 1 1 3 3 3 3 1 2 2 3 3 3 1 2 2 3 1 1 
1 4 2 2 2 2 3 3 2 1 4 4 4 2 2 2 4 4 4 4 4 1 1 1 3 1 3 1 1 3 3 3 1 1 1 1 3 3 3 1 
4 4 2 2 2 2 2 2 2 4 4 2 2 2 2 3 3 3 4 4 4 1 1 3 1 1 1 3 3 3 3 1 3 5 1 1 3 3 1 1 
4 4 4 2 2 2 2 2 2 2 4 4 2 2 2 1 3 4 4 4 4 3 1 1 1 4 1 1 1 1 3 3 3 1 3 3 3 4 4 4 
4 4 4 2 2 2 2 4 1 1 4 2 3 2 1 1 4 4 4 4 1 1 1 1 1 4 1 1 1 1 3 3 3 3 4 4 4 4 3 1 
3 4 1 4 2 2 2 4 4 4 1 1 1 3 2 2 1 2 3 3 3 2 2 2 1 4 4 1 3 3 3 3 3 1 3 4 4 4 1 1 
4 3 1 1 2 2 2 4 4 4 1 1 3 2 2 2 2 1 3 1 1 2 2 2 4 4 3 3 1 3 1 1 3 3 3 2 4 4 2 1 
4 4 3 1 1 1 1 1 2 1 1 1 3 2 3 2 2 2 1 1 1 3 2 4 4 4 4 3 3 1 3 3 1 3 3 2 3 4 2 4 
4 1 1 1 1 1 3 2 2 2 1 1 3 2 3 2 2 2 2 1 3 3 3 3 1 4 1 1 1 1 1 3 3 3 2 3 4 2 2 4 
1 1 1 4 4 3 4 4 4 4 1 2 2 2 1 4 2 2 2 2 1 3 3 3 3 3 2 1 1 1 1 1 3 3 3 2 4 4 2 4 
1 1 4 4 4 4 4 4 2 4 4 1 3 2 2 4 2 2 2 2 2 2 3 3 3 2 2 2 2 1 1 1 3 2 2 4 4 4 4 1 
1 1 1 1 4 4 4 4 4 2 4 1 3 3 2 1 4 4 4 3 3 2 2 1 1 3 1 2 2 2 2 4 4 2 2 1 4 4 4 1 
1 1 4 4 4 3 4 4 4 2 2 1 3 1 2 2 2 4 4 1 1 2 2 1 1 2 2 1 2 4 4 4 4 1 4 1 4 4 3 1 
1 1 1 4 4 1 3 4 3 3 3 2 1 3 3 2 4 4 4 4 1 2 2 2 1 2 2 2 2 4 4 1 1 1 4 4 1 4 4 4 
2 2 1 4 4 1 3 3 3 3 3 4 4 4 3 3 4 4 2 2 2 2 2 1 1 1 4 4 4 2 2 2 1 1 4 4 4 4 4 4 
1 2 1 1 4 1 3 3 1 3 3 4 4 4 4 3 3 4 1 1 1 2 2 1 1 4 4 4 4 4 1 1 1 1 4 4 4 3 4 4 
1 2 1 4 4 1 3 3 1 1 4 4 4 3 4 4 3 3 1 1 2 2 4 4 4 1 1 1 4 1 1 1 1 1 1 3 4 4 4 4 
1 4 4 4 4 3 3 1 3 1 1 4 4 3 -1 4 4 3 1 1 3 2 4 4 4 1 1 1 1 1 1 1 1 1 3 3 1 3 3 4 
4 4 4 1 4 4 3 1 3 3 4 4 4 2 3 2 3 2 2 3 2 2 2 4 4 1 1 4 4 1 1 1 1 3 3 1 3 2 2 4 
1 4 4 3 4 4 3 1 3 3 4 3 4 2 2 2 2 2 2 2 3 4 4 4 2 2 1 1 4 4 1 1 4 4 4 1 3 3 2 4 
1 3 1 4 4 3 3 4 4 4 2 2 2 2 3 3 1 1 2 3 4 4 4 4 1 1 1 4 1 1 1 1 4 4 4 3 2 2 4 4 
1 3 4 4 1 1 1 4 4 4 2 2 1 2 1 1 1 1 1 2 1 2 2 4 4 1 4 4 4 1 1 1 3 4 3 4 2 3 2 4 
1 1 1 1 1 1 4 4 4 4 2 1 2 1 1 1 1 1 2 1 1 2 2 4 4 4 4 4 2 2 1 3 3 3 3 4 1 4 4 1 
1 1 1 1 6 1 1 4 4 3 4 3 1 1 1 1 3 4 4 4 4 4 4 3 4 4 4 4 2 2 2 1 3 3 4 4 4 4 4 4 
3 1 1 4 1 1 4 1 4 3 3 1 3 3 3 3 4 4 4 4 4 1 4 4 4 4 3 3 2 2 2 3 3 1 4 4 4 4 4 4 
3 3 4 4 1 4 4 4 1 4 4 3 1 3 3 3 1 1 3 1 4 1 1 1 1 3 1 3 3 2 2 1 1 1 1 4 4 4 4 3 
3 4 1 1 4 4 4 4 4 1 4 3 1 1 1 1 3 3 3 1 4 1 1 1 1 1 3 3 1 2 1 1 1 1 4 4 4 4 4 3 
1 4 4 4 4 4 4 4 4 1 3 4 1 1 1 1 1 1 1 4 1 1 1 1 1 3 3 3 3 1 1 1 1 4 4 4 4 4 4 4 
3 4 4 1 4 4 4 4 3 3 4 3 1 1 1 1 1 4 4 4 1 1 1 1 3 3 3 3 1 1 1 3 4 4 1 4 4 1 4 1 
1 2 4 4 4 4 4 4 1 3 3 1 1 1 1 1 2 2 4 4 4 1 1 3 3 3 3 1 1 2 1 3 3 4 4 4 4 4 4 3 
4 4 4 4 4 2 3 4 1 3 3 3 1 1 1 1 1 1 1 4 4 4 1 3 1 3 1 1 2 2 3 4 4 4 1 4 4 4 3 1 
4 4 4 1 1 2 2 1 1 3 3 3 3 1 1 1 1 1 1 1 2 2 1 1 3 3 3 1 2 2 2 2 4 4 1 4 4 4 1 1 
4 4 4 2 2 2 1 1 1 1 1 3 1 1 1 1 1 1 1 1 2 1 1 1 3 1 1 2 2 2 2 4 4 1 1 4 4 1 1 1 
21 6 Bison true
29 11 Seeker true
27 17 Octopus true
10 7 Bison true
3 6 Grizzly true
3 10 Grizzly true
13 13 Grizzly true
33 13 Atlas true
9 11 Atlas true
27 6 Charlie true
25 6 Charlie true
21 10 Charlie true
12 12 Hawkeye true
36 14 Eagle true
3 4 Eagle true
34 17 Lynx true
9 13 Lynx true
24 18 Rabbit true
13 15 Rabbit true
9 14 Rabbit true
29 15 Hunter true
11 13 Hunter true
2 15 Hunter true
4 29 Hadrian false
16 33 Hadrian false
15 30 Kilroy false
7 27 Kilroy false
20 33 Eagle false
3 30 Eagle false
22 33 Lynx false
10 28 Lynx false
25 35 Lynx false
25 32 Bison false
16 28 Bison false
15 27 Bison false
10 24 Bison false
9 22 Bison false
24 30 Kilroy false
7 23 Kilroy false
28 25 Charlie false
11 20 Charlie false
31 28 Lenet false
6 24 Lenet false
34 29 Falcon false
3 24 Falcon false
5 26 Falcon false
33 30 Falcon false
33 27 Rabbit false
33 26 Rabbit false
33 25 Rabbit false
8 21 Rabbit false
8 22 Rabbit false
8 23 Rabbit false
10 33 Giant false
23 26 Slagger false
17 24 Slagger false
