10
10
1 1 1 1 1 1 1 1 1 1 
1 1 1 1 1 5 1 1 1 1 
1 -1 3 0 0 1 1 1 1 1 
1 -1 3 1 0 1 1 1 1 1 
1 1 -1 -1 -1 0 0 0 1 1 
1 1 1 1 1 1 1 0 1 1 
1 1 1 6 3 2 3 1 0 1 
1 1 1 1 1 2 1 1 1 1 
1 1 2 2 2 2 3 1 1 1 
1 3 3 2 2 2 3 1 1 1 
